"cod","mun","total","hombres","mujeres","date"
44085,"Cosa",106,58,48,1998
44085,"Cosa",105,57,48,1999
44085,"Cosa",104,56,48,2000
44085,"Cosa",96,51,45,2001
44085,"Cosa",93,48,45,2002
44085,"Cosa",96,51,45,2003
44085,"Cosa",97,51,46,2004
44085,"Cosa",88,43,45,2005
44085,"Cosa",87,45,42,2006
44085,"Cosa",86,45,41,2007
44085,"Cosa",77,42,35,2008
44085,"Cosa",67,38,29,2009
44085,"Cosa",64,38,26,2010
44085,"Cosa",60,35,25,2011
44085,"Cosa",61,36,25,2012
44085,"Cosa",60,36,24,2013
